11 16 120
================
=    G  ^     @=
=====#==========
=X      !   G  =
===========#====
=  W      ^    =
=====*======*===
=  !    T  G  X=
===*======*=====
=K      ^   M  =
================
1
3 1 7 14