11 20 120
====================
=    @   *#*  K    =
= X   ^  *=*     X =
=        *=*       =
==#==   =====   ====
=W  = G =   = G = G=
=   =====   =====  =
=     =       =    =
= X   !   T ^ !  X =
=     =       = M  =
====================
2
2 2 8 17 8 2 2 17
