11 10 -1
==========
= W=@    =
= ======#=
=T* !=X  =
= ====== =
= X=  M= =
= == === =
= ^ *    =
= ====== =
=K       =
==========
1
3 6 5 2