17 23 -1
=======================
=   ^              @  =
==========#============
=  X    !             =
==*=*=*=*=*=*=*=*=*=*==
=       ^      G      =
===#===================
=           W         =
=*=*=*=*=*=*=*=*=*===*=
=    G   ^      !  X  =
============ ==========
=   T                 =
==*=*=*=*=*=*=*=*=*=*==
=    ^             M  =
======= ====== ========
=  K          G       =
=======================
1
3 3 9 19